9 17
O__+_+__+__+__+_+
_#_#_#_#_#_#_#_#_
__+_+++++++++++++
_#_#+#_#+#_#_#_#_
___++__+++___+++_
_###+#_#+#_#_#_#_
___++_+_++_++____
_#_#_#_#_#_#+#_#_
O_____#__________
