9 17
O__+_+__+__+_O+_+
_#_#_#_#_#_#_#_#_
__+_+++++++++++++
_#_#+#_#+#_#_#_#_
___++__+++___+++_
_###+#_#+#_#_#_#_
___++_+_++_++__O_
_#_#_#_#_#_#+#_#_
___O__#__________