9 29
O__+_+___+_+++__+_++_+__+___O
_#_#_#_#_#_#_#_#_#_#_#_#_#_#_
__+_++++++++++____________+++
_#_#+#_#+#_#_#_#_#_#_#_#_#_#_
___++__+++___+++_+++___+_+++_
_###+#_#+#_#_#_#_#_#_#_#_#_#_
#__++_+_++_++__O_++_+__+__+__
_#_#_#_#_#_#+#_#_#_#_#_#_#___
___O__#__________++++++_O_+_+
